#######
#E  # #
### ###
# # # #
# # # #
#     #
#####S#