#S#####
#
# # # #
# ### #
# ### #
#
#####E#
