#S#####

#     #
# # # #
# ### #
# ### #
#   # #
###E###




