#S#####
#     #
# E # #
# ### #
# ### #
#   E #
#######